5 1 1 1 1 1 1 1 1 1 1 1 1 1 1 5
4 0 0 0 0 0 0 0 0 0 0 0 0 0 0 2
4 0 0 0 0 0 0 0 0 0 0 0 0 0 0 2
4 0 0 0 0 0 0 0 0 6 6 6 6 6 6 2
4 0 0 0 0 0 0 0 0 0 0 0 0 0 0 2
4 0 0 0 0 0 0 0 0 0 0 0 0 0 0 2
4 0 0 0 0 0 0 0 0 0 0 0 0 0 0 2
4 6 6 6 6 6 6 0 0 0 0 0 0 0 0 2
4 0 0 0 0 0 0 0 0 0 0 0 0 0 0 2
4 0 7 0 0 0 0 0 0 7 0 0 0 0 0 2
4 0 0 0 0 0 0 0 0 0 0 0 0 0 0 2
5 3 3 3 3 3 3 3 3 3 3 3 3 3 3 5